NO ./ressources/hedge0.ppm
SO ./ressources/hedge1.ppm
WE ./ressources/hedge2.ppm
EA ./ressources/hedge3.ppm

F 220,100,0
C 225,30,0

111111111111112111111111211111211
1   1  1  1     1    4    1     1
1 2 1     2 1 1   1  1 1  1 1   1
111 1 11  1 1  1 1  1  1 2    111
1   4   121  1  1  2  1   1 1   1
1 1  1     1  4   4  1    14    2
2  1 11211 11  1 1  1111  1   111
1 1        10  1 1   1    2 11  1
1   11  1 1  111L211      1     1
14 1   11 1111     1141D11111D211
1  1 1  4    1     1    1       4
1 41 12  12  D  S  L    1 1     1
4  1    1    4     1      1     1
11D111 11 1111     2111D11211D111
1   1   1    11L1111 1     1    1
4   2 1   11 1     2 1   2 1 11 1
1   1 1114   2     1 1 1   1 1  1
1   4      1 1 1 2 1 1 11 1  1 21
1414   11  112     2 1 2   1 1 11
1   2 1   2  1     1 1 1 4 1    1
4   1   1   11121L21   1   1211 1
1   431211311      11 111 1     1
4   1       1      1   2   11 1 1
11L11       1      1 1 1 1 1    2
2           L      2 1 1     11 1
1           1      1      1 1   1
121311311331113123111121111211211
